111111111111
10CE00000011
10P011000011
1P0011111111
100P00000001
111111111101
10C000000001
10P011111101
1P0010C00101
10EP10000001
111111111111
