1111111111111111111111111111111
10ECP00000000000000000000000001
10ECP00000000000000000000000001
10ECP00000000000000000000000001
10ECP00000000000000000000000001
10ECP00000000000000000000000001
10ECP00000000000000000000000001
10ECP00000000000000000000000001
10ECP00000000000000000000000001
10ECP00000000000000000000000001
10ECP00000000000000000000000001
10ECP00000000000000000000000001
10ECP00000000000000000000000001
10ECP00000000000000000000000001
10ECP00000000000000000000000001
10ECP00000000000000000000000001
10ECP00000000000000000000000001
10ECP00000000000000000000000001
10ECP00000000000000000000000001
10ECP00000000000000000000000001
10ECP00000000000000000000000001
10ECP00000000000000000000000001
10ECP00000000000000000000000001
10ECP00000000000000000000000001
10ECP00000000000000000000000001
10ECP00000000000000000000000001
10ECP00000000000000000000000001
10ECP00000000000000000000000001
10ECP00000000000000000000000001
10ECP00000000000000000000000001
10ECP00000000000000000000000001
10ECP00000000000000000000000001
10ECP00000000000000000000000001
10ECP00000000000000000000000001
10ECP00000000000000000000000001
10ECP00000000000000000000000001
10ECP00000000000000000000000001
10ECP00000000000000000000000001
10ECP00000000000000000000000001
10ECP00000000000000000000000001
10ECP00000000000000000000000001
10ECP00000000000000000000000001
10ECP00000000000000000000000001
10ECP00000000000000000000000001
10ECP00000000000000000000000001
10ECP00000000000000000000000001
10ECP00000000000000000000000001
10ECP00000000000000000000000001
10ECP00000000000000000000000001
10ECP00000000000000000000000001
10ECP00000000000000000000000001
10ECP00000000000000000000000001
10ECP00000000000000000000000001
10ECP00000000000000000000000001
10ECP00000000000000000000000001
10ECP00000000000000000000000001
10ECP00000000000000000000000001
10ECP00000000000000000000000001
10ECP00000000000000000000000001
10ECP00000000000000000000000001
10ECP00000000000000000000000001
10ECP00000000000000000000000001
10ECP00000000000000000000000001
10ECP00000000000000000000000001
10ECP00000000000000000000000001
10ECP00000000000000000000000001
10ECP00000000000000000000000001
10ECP00000000000000000000000001
10ECP00000000000000000000000001
10ECP00000000000000000000000001
10ECP00000000000000000000000001
10ECP00000000000000000000000001
10ECP00000000000000000000000001
10ECP00000000000000000000000001
10ECP00000000000000000000000001
10ECP00000000000000000000000001
10ECP00000000000000000000000001
10ECP00000000000000000000000001
10ECP00000000000000000000000001
10ECP00000000000000000000000001
10ECP00000000000000000000000001
10ECP00000000000000000000000001
10ECP00000000000000000000000001
10ECP00000000000000000000000001
10ECP00000000000000000000000001
10ECP00000000000000000000000001
10ECP00000000000000000000000001
10ECP00000000000000000000000001
10ECP00000000000000000000000001
10ECP00000000000000000000000001
10ECP00000000000000000000000001
10ECP00000000000000000000000001
10ECP00000000000000000000000001
10ECP00000000000000000000000001
10ECP00000000000000000000000001
10ECP00000000000000000000000001
10ECP00000000000000000000000001
10ECP00000000000000000000000001
10ECP00000000000000000000000001
10ECP00000000000000000000000001
10ECP00000000000000000000000001
10ECP00000000000000000000000001
10ECP00000000000000000000000001
10ECP00000000000000000000000001
10ECP00000000000000000000000001
10ECP00000000000000000000000001
10ECP00000000000000000000000001
10ECP00000000000000000000000001
10ECP00000000000000000000000001
10ECP00000000000000000000000001
10ECP00000000000000000000000001
10ECP00000000000000000000000001
10ECP00000000000000000000000001
10ECP00000000000000000000000001
10ECP00000000000000000000000001
10ECP00000000000000000000000001
10ECP00000000000000000000000001
10ECP00000000000000000000000001
10ECP00000000000000000000000001
10ECP00000000000000000000000001
10ECP00000000000000000000000001
10ECP00000000000000000000000001
10ECP00000000000000000000000001
10ECP00000000000000000000000001
10ECP00000000000000000000000001
10ECP00000000000000000000000001
10ECP00000000000000000000000001
10ECP00000000000000000000000001
10ECP00000000000000000000000001
10ECP00000000000000000000000001
10ECP00000000000000000000000001
10ECP00000000000000000000000001
10ECP00000000000000000000000001
10ECP00000000000000000000000001
10ECP00000000000000000000000001
10ECP00000000000000000000000001
10ECP00000000000000000000000001
10ECP00000000000000000000000001
10ECP00000000000000000000000001
10ECP00000000000000000000000001
10ECP00000000000000000000000001
1111111111111111111111111111111
